010100001000010000
010101101011110111
010000101000010000
010111101011010110
000100000010000100
010101111111011110
010100001000010000
010101101011110111
010000101000010000
010111101011010110
000100000010000100
010101111111011110
010100001000010000
010101101011110111
010000101000010000
010111101011010110
000100000010000100
010101111111011110
010100001000010000
010101101011110111
010000101000010000
010111101011010110
000100000010000100
010101111111011110