0100010000
0101011110
0101000010
0101111010
0101B00000