010100001000010000001000010000
010101101011110111101011010111
010000101000010000100001010000
010111101011010110101111010110
000100000010000100001000000100
010101111111011110101011111110
010100001000010000101000010000
010001101011110111101011010111
010100001000010000001000010000
010101101011110111101011010111
010000101000010000100001010000
010111101011010110101111010110
000100000010000100001000000100
010101111111011110101011111110
010100001A00010000101000010000
010001101011110111101011010111
010100001000010000001000010000
010101101011110111101011010111
010000101000010000100001010000
010111101011010110101111010110
000100000010000100001000000100
010101111111011110101011111110
010100001000010000101000010000
010001101011110111101011010111
010100001000010000001000010000
010101101011110111101011010111
010000101000010000100001010000
010111101011010110101111010110
000100000010000100001000000100
010101111111011110101011111110
010100001000010000101000010000
010001101011110111101011010111