0000000000000000000100000000000000000001
0101010101010101010101011101110101011101
0000010100000100010001000100000000000001
0101110101010101110101110101111101110101
0000000000000000000100000000000101000001
1111010101010111010101110101110101010101
0000000000010000010001000100000000010101
0101011101010101010111010111110101010101
0100000000000000000000000000000001010101
0111010111011101011101110101010101110101
0000010000000001010000010100000001000001
0111010101110101010101010111110111010101
0000000000000101000100000000000100000101
0101010101010101010111110101010111110111
0001010001010100010001010101000100010001
0111011101010101111101110101010101011101
0000010001010000000100010001000000000101
0101011101010101010101010111010101011101
0000000000000001000001000000000000010101
0111010111010101010101011101010101010101
0000000000000000010101000100000101000001
0101010101010101010101110101011101010111
0000010000000000010001000000000000010001
11010101111111110101110111A1010101010101
0100000001010001010100000000000000000001
0101110101010111010101010101110101010101
0000000000000000000101000000000100000001
1101110101110101011101011111110101011101
0000000000010101000001010000000000000001
0101110101110101111111010111011101011101
0000010100000B00000100000100010001000101
0101011101010111010101011101010101010101
0000010001010000010100010001000101000101
0111010101010101010101111101010111010101
0000000001010100010000000000010001010101
0101010101010101010101111111011101111101
0001010101000000000000010001000100000101
0101111101111101010101010101011101111101
0000000000000000010001000000000101000001
1111111111111111111111111111111111111111