11111111111111111111111111111111111111111111111111
00010100000000000001000000000000000000000000000001
01010101010101010101011101010101010111011101010101
00000000000000000101000101000000000000000001010101
01110101010101011101011101010101110101010101110111
00000000010100000000000100000001000100000000000001
01011111010101010111010111010101010101110101110101
00000001000101010101000100000100000001000100000001
01010101011111010101010101010111011101010101010101
00010101000000000000010001010000000000000100A10001
01010101110101010101010101010101111111010111010101
00010000000001000100010100000001000000010101000001
01111101B11101010111110101010101011111111101011111
00000100010001010000010001000001010000010001000001
01010101010111011101011101010101011101110111011101
00000000000000000100000100000000000001000000000101
01010101010101010101111101011111010101111101110101
00000100000001000000010000000000000000010000010001
01011101010101011101110101010101010101010111010101
00000000000000000000000000000100010100000000000001
01110101010101010101010101010101010101010101010101
01000001000000000000000000000000000100000000000001
01111101010101011101111111111111111101110111010101
00000100000101000000000101000001010001000001000001
01010101110111110111110101110111010101110111010101
00000001000001010100000001000100000001000100010001
01010101010101011101011101011111111101110101110101
00000001000101000000000101010101000000000001000001
01010101010101010101111101111101010111111101010101
00010000010000000000010000000000000000010100010001
11010101010111011101010101111101110101010111010101
00000000000000010100000100000000000100010101010001
11010101010101010101010101110111110101111101110101
01010001000000010000000001000000010000000000000001
01010101010101110101110101011101111101011101111101
01000001000000010100000000000100000000000000010001
01110111010101010101010111011101011101010101010101
00010000000101000100000000000000000000010000010101
01010111011101010111011101010101011101010101010101
00000000000000010000000100000000000100000100010001
11111101010101110101011101010101011101110101010111
00000000010101010000000001010000000000010100010101
01010101010101010101010101010101011101110101010101
00000000000000000100010000010001000001010101000001
11010101010101110101010101010111011101010111110111
00010100000100010000010000000000000000000000000001
01010101010111010111011101011111010101011101010101
01010001000100000001000100000001000001000000000101
01010101111111011101010111010101010111010101111101
01000000000000010000000001000001000100010000000001