A10100001000010000001000010000100001100001000010000
010101101011110111101011010111101110101101011110111
010000101000010000100001010000100000000101000010000
010111101011010110101111010110101101111101011010110
000100000010000100001000000100001000000000010000100
010101111111011110101011111110111101101111011011110
010100001000010000101000010000100000100001000010000
010001100011000111101011000111101111101101011110111