0101000010000
0101011010111
0100001010000
0101111010110
00010000001B0
0101A11111110
0101000010000
0101011010111
0100001010000
0101111010110
0001000000100
0101011111110