0100000000
0001011110
A101000010
0101011010
0001B00000