A101000010000
0101011010111
0100001010000
0101111010110
00010000001B0
0101011110000